[LONG]
P-PAFRCPADDCOLUMN=Recipe file writing: define a column
P-PAOPENPROJECT=Open the targetProject
P-PASETVAR3DIMS=Set variable as 3 dimension array
P-PAEMBEDVARSYMBOL=Set/reset variable symbol embedding flag
P-PASETTRACEMODE=Set report information level
P-PASETPARAMETERDESC=Set input parameter description
P-PAFLDDIVERGENCE=LD file writing: start an OR divergence
P-PAFBDSOUTPUTVAR=Sequential FBD file writing: input variable
P-PATPLSETKEY=Set a key for aliasing during copy
P-PAFASIINPUT=AS-i file writing: add an input variable to the last created slave
P-PADELETEPROGRAMFOLDER=Delete a folder in the workspace
P-PAFILEOPENWRITESTRINGTABLE=Open a string table resource for writing
P-PAFBDSRETURN=Sequential FBD file writing: return
P-PAFFBSELECTSLAVE=Select a "slave" node
P-PACREATEPROJECTFROMTEMPLATE=Create the target project from a template
A-<PROJECT>=Make a test program for calling a UDFB or subprogram
P-PATPLCOPYSOURCE=Copy source code of a template
P-PAFLDNEXTBRANCH=LD file writing: start a new branch in an OR divergence
P-PASFCSTEP=SFC file writing: add a SFC step
P-PATPLCOPYALL=Copy source, variables and definitions of a template
P-PASETIOBOARDPARAM=Set a parameter of an IO board
P-PAFILEOPENWRITESPYLIST=Open a spy list for writing
P-PASFCTRANS=SFC file writing: add a SFC transition
P-PACREATEPROJECT=Create the target project
P-PASFCADDLV2LINE=SFC file writing: add line to level 2 program
P-PACREATEOUTPUTPARAM=Add an output parameter to a sub-program or UDFB
P-PASETPROGRAMCOMMENT=Set program comment text
P-PASETOPTION=Set a project settings option
P-PAFLDCONTACT=LD file writing: add a contact
P-PAFFBCREATEVAR=Create a "variable" node under the selected slave
P-PAFILEOPENWRITEBINDING=Open the Binding configuration for writing
P-PAFTEXTLINE=Write a string to a text file
P-PACREATEVAR=Create a global variable
P-PAFLDCONVERGENCE=LD file writing: terminate an OR divergence
P-PAFBDSINPUTVAR=Sequential FBD file writing: input variable
P-PAFASIOUTPUT=AS-i file writing: add an output variable to the last created slave
P-PACREATEINPUTPARAM=Add an input parameter to a sub-program or UDFB
P-PASFCJUMP=SFC file writing: add a jump to a SFC step
P-PASFCCNV=SFC file writing: finish a divergence
P-PAPROFILEVAR=Set variable profile and related properties
P-PAFASIMASTER=AS-i file writing: add a master
P-PADELETESTRUCT=Delete a data structure
P-PAFFBSELECTMASTER=Select a "master" node
P-PACREATESUBPROGRAM=Create a sub-program
P-PAENUMPROGRAMFOLDER=Enumerate folders of programs
P-PAFLDRETURN=LD file writing: add a <RETURN> symbol
P-PAFBDSBLOCK=Sequential FBD file writing: block
P-PACREATEUDFB=Create a UDFB
P-PAENUMSTRUCT=Enumerate data structures
P-PASETVARCOMMENT=Set variable comment
P-PATRACE0=Report message - no argument
P-PADELETEVAR=Delete a variable
P-PASETVAR1DIM=Set variable as 1 dimension array
P-PAFFBSELECTVAR=Select a "variable" node
P-PAFSPYADDVARIABLE=Spy list file writing: Add a variable to the list
P-PADELETEPROGRAM=Delete a program
P-PAFLDJUMP=LD file writing: add a 'jump' symbol
P-PAFASISLAVEDIAG=AS-i file writing: Add a diagnostic variable to the last created slave
P-PATRACE1=Report message - 1 argument
P-PAEDITPARAMETERLIST=Edit input parameters in a dialog box
P-PAFTEXTSTRING=Write a string to a text file
P-PADELETEALLIOBOARDS=Delete all IO boards
P-PAFBINDVARDATESTAMP=Binding file writing; add a date stamp variable
P-PAFILEOPENWRITESIGNAL=Open an analog signal resource for writing
P-PAFRCPADDVALUE=Recipe file writing: add a value to a variable
P-PAFMODBUSVARIABLE=Create a MODBUS variable
P-PAFRCPADDVARIABLE=Recipe file writing: add a variable to the recipe
P-PAFSIGNALADDPOINT=Signal resource file writing: add a column
P-PAFLDCOIL=LD file writing: add a coil
P-PAFSTBADDSTRING=String table file writing: add a string value
P-PATRACE2=Report message - 2 arguments
P-PAASKPASSWORD=Prompt the user for a password
P-PASFCBRANCH=Start a new branch in a divergence
P-PAMESSAGEBOX=Display a message box
P-PACREATESTRUCT=Create a data structure
P-PAFBINDPUBLICVAR=Binding file writing: add a public variable
P-PAENUMIOBOARDS=Enumerate IO boards
P-PAFMODBUSMASTER=Create a new MODBUS master port
P-PADELETEIOBOARD=Delete an IO board
P-PACREATESFCCHILDPROGRAM=Create a child SFC program
P-PATRACE3=Report message - 3 arguments
P-PASETPROJECTCOMMENT=Set project comment text
P-PAFBDSCOMMENT=Sequential FBD file writing: comment box
P-PAFBDSBREAK=Sequential FBD file writing: network break
P-PAFLDENDRUNG=LD file writing: finish a rung
P-PASETIOALIAS=Define an alias for a channel of an IO board
P-PAGETIOBOARDDESC=Get information about an IO board
P-PAFBDSOUTPUTRETURN=Sequential FBD file writing: return on output
P-PAFSIGNALADDCOLUMN=Signal resource file writing: add a column
P-PAFBINDEXTERNPORT=Binding file writing: add an external port
P-PAFASIAPPLYCONFIG=AS-i file writing: set "apply configuration" flag
P-PATRACE4=Report message - 4 arguments
P-PAFMODBUSSLAVE=Select the MODBUS Slave port (server) for writing
P-PAFFBCREATESLAVE=Create a "slave" node, under the selected master
P-PATPLREMOVEKEYS=Remove all keys used for aliasing
P-PAFILEOPENWRITE=Open any project file for writing
P-PAFILEOPENWRITEFIELDBUS=Open a fieldbus configuration file for writing
P-PASFCDIV=SFC file writing: start a divergence
P-PAGETVARDESC=Get information about a variable
P-PAFBDSJUMP=Sequential FBD file writing: jump
P-PAFSTBADDCOLUMN=String table file writing: add a column
P-PAGETSTRUCTDESC=Get information about a data structure
P-PAENUMPROGRAM=Enumerate programs
P-PAFBINDCNXSTATUS=Binding file writing: add a connection status
P-PAFILEOPENWRITEASI=Open the AS-i configuration file for writing
P-PAFFBCREATEMASTER=Create a "master" node
P-PAFMODBUSREQUESTMASTER=Create a MODBUS Master request
P-PAFTEXTEOL=Write end of line character to a text file
P-PAFFBSELECTROOT=Select the root node
P-PAGETLANGUAGE=Get Workbench language
P-PAFBINDVARTIMESTAMP=Binding file writing: add a time stamp variable
P-PAFBDSLABEL=Sequential FBD file writing: label
P-PAFBDSOUTPUTJUMP=Sequential FBD file writing: jump on output
P-PASETSTRUCTCOMMENT=Set data structure comment text
P-PACREATEPROGRAM=Create a main program
P-PATPLCOPYVARS=Copy local variables of a template program
P-PAFILECLOSE=Close an open file
P-PACREATEPROGRAMFOLDER=Create a folder in the workspace
P-PAFILEOPENWRITEPROGRAMSRC=Open program source code file for writing
P-PAFMODBUSREQUESTSLAVE=Create a MODBUS Slave request
P-PAFASIMASTERDIAG=AS-i file writing: add a diagnostic variable to the last created master
P-PAFLDHORZSEGMENT=LD file writing: add a horizontal line segment
P-PAFFBSETPROPERTY=Set property of the selected node
P-PASFCISTEP=SFC file writing: add an initial SFC step
P-PATPLCOPYDEFINITIONS=Copy definitions of a template
P-PAFILEOPENWRITEMODBUS=Open the Modbus configuration file for writing
P-PASENDPROGRAMTOFOLDER=Move a program in a folder
P-PAFILEOPENWRITEPROGRAMDEF=Open program definitions file for writing
P-PAGETPROGRAMDESC=Get information about a program
P-PAFLDCOMMENTLINE=LD file writing: add a comment line
P-PAADDLIBRARY=Add a library to the target project
P-PAFBINDEXTERNVAR=Binding file writing: add an external variable
P-PASFCADDLV2EOL=SFC file writing: add an end of line to level 2 program
P-PAFLDSTARTRUNG=LD file writing: start a rung
P-PASFCADDLV2STRING=SFC file writing: add text to level 2 program
P-PAFLDBLOCK=LD file writing: add a block
P-PAENUMVAR=Enumerate variables
P-PACREATEIOBOARD=Create an instance of an IO device
P-PACOPYPROGRAM=Copy a program
P-PASETIOBOARDCOMMENT=Set IO board comment text
P-PASETVAR2DIMS=Set variable as 2 dimension array
P-PAFASISLAVE=AS-i file writing: add a slave to tyheh last created master
P-PAFILEOPENWRITERECIPE=Open a recipe file for writing
P-PAFBINDVARSTATUS=Binding file writing: add a variable status
P-PASETVARINITVALUE=Set initial value of a variable
